6 6
3 2 3 1 2 3
1 5 4 3 4 1
3 5 6 1 2 1
1 1 2 3 1 2
3 2 3 4 5 6
4 2 1 2 3 4