8 8
3 2 3 1 2 3 3 1
3 5 4 3 2 3 2 2
3 5 6 1 2 1 1 5
1 1 2 3 1 2 4 6
3 2 3 4 5 6 5 1
4 2 1 2 3 4 5 3
1 1 2 3 1 2 3 4
3 5 4 3 2 3 1 5